A.......................
........................
........................
..##..##..##..##..##....
........................
........................
............M...........
........................
.##....##....##...##....
........................
........................
........................
.......D................
