A...................
.###################
....................
.####.#####.##.#####
....................
.###..###..####..##.
...........##...##..
.####.#####.####.###
....................
.##.#.#.#.##.#.#.#..
....................
.###################
....................
.###..###.###..###..
....D...............
