A.........
.#####....
......#...
..#####..#
.#........
....#...#D
..####...
